[LevelName]
InGameEditor
[ArraySpecs]
40
25
[TileMap]
0000000000000000000000000000000000000000
0000000000000000000000000000000000000000
0000000000000000000000000000000000000000
0000000000000000000000000000000000000000
0000000000000000000000000000000000000000
0000000000000000000000000000000000000000
0000000000000050000000000000000000000000
0000000000500000000000000000000000000000
0000000000000000000000000000000000000000
0000006000000000000400000030000000000000
0000000000000000000000000000000000000000
0000000000000000000000020000000000000000
0000700000000000000000000000000000000000
0000000000000000000000000000000000000000
0000400050060070008009000000000000000000
0000000000000000000000000000000000000000
0000000000000000000000000000000000000000
0000000800000080000008000008888888888009
0000000000000000000000000000000000000000
0000000000000000000000000000000000000000
0000000000000000000000000000000000000000
0000000000000000000000000000000000000000
2222111112222222122222222221222222222222
1111111111111212121212121211122222111111
1111111111111111111111111111111111111111
[EntityMap]
0000000000000000000000000000000000000000
0000000000000000000000000000000000000000
0000000000000000000000000000000000000000
0000000000000000000000000000000000000000
0000000000000000000000000000000000000000
0000000000000000000000000000000000000000
0000000000000000000000000000000000000000
0000000000000000000000000000000000000000
0000000000000000000000000000000000000000
0000000000000000000000000000000000000000
0000000000000000000000000000000000000000
0000000000000000000000000000000000000000
0000000000000000000000000000000000000000
0000000000000000000000000000000000000000
0000000000000000000000000000000000000000
0000000000000000000000000000000000000000
0000000000000000000000000000000000000000
0000000000000000000000000000000000000000
0000000000000000000000000000000000000000
0000000000000000000000000000000000000000
0000000000000000000000000000000000000000
0000000000000000000000000000000000000000
0000000000000000000000000000000000000000
0000000000000000000000000000000000000000
0000000000000000000000000000000000000000
