[LevelName]
resources/Levels/TestLevel.txt
[ArraySpecs]
25
25
[TileMap]
0 8 9 10 0 0 0 0 0 0 0 0 0 0 0 0 0 0 0 0 0 0 0 0 0 
1 0 0 0 0 0 0 0 0 0 0 0 0 0 0 0 0 0 0 0 0 0 0 0 0 
2 0 0 0 0 0 0 0 0 0 0 0 0 0 0 0 0 0 0 0 0 0 0 0 1 
2 0 0 0 0 0 0 0 0 0 0 0 0 0 0 0 0 0 0 0 0 0 0 0 0 
2 0 0 0 0 0 0 0 0 0 0 0 0 0 0 0 0 0 0 0 0 0 0 0 0 
0 0 0 0 0 0 0 0 0 0 0 0 0 0 0 0 0 0 0 0 0 0 0 0 0 
0 0 0 0 0 0 0 0 0 0 0 0 0 0 0 0 0 0 0 0 0 0 0 0 0 
0 0 0 0 0 0 0 0 0 0 0 0 0 0 0 0 0 0 0 0 0 0 0 0 0 
0 0 0 0 0 0 0 0 0 0 0 0 0 0 0 0 0 0 0 0 0 0 0 0 0 
0 0 0 0 0 0 0 0 0 0 0 0 0 0 0 0 0 0 0 0 0 0 0 0 0 
0 0 0 0 0 0 0 0 0 0 0 0 0 0 0 0 0 0 0 0 0 0 0 0 0 
0 0 0 0 0 0 0 0 0 0 0 0 0 0 0 0 0 0 0 0 0 0 249 0 0 
0 0 0 0 0 0 0 0 0 0 0 0 0 0 0 0 0 0 0 0 0 0 0 0 0 
0 0 0 0 0 9 0 0 0 0 0 0 0 0 0 0 0 0 0 0 0 0 0 0 0 
0 0 0 0 0 0 9 0 0 0 0 0 0 0 0 0 0 0 0 0 0 0 0 0 0 
0 0 0 0 0 0 0 0 0 255 0 0 0 0 0 0 0 0 0 0 0 0 0 257 0 
0 0 0 0 0 0 0 0 0 0 0 0 0 249 0 0 0 0 0 0 0 0 0 0 0 
0 0 0 0 0 0 0 0 0 0 0 0 0 0 0 0 0 0 0 0 0 0 0 0 0 
125 0 0 0 265 266 70 70 194 0 0 0 0 0 0 0 0 0 0 0 0 0 0 0 0 
59 125 0 0 29 30 59 59 211 0 0 0 0 0 0 0 0 0 0 0 0 0 0 0 0 
13 13 125 0 0 0 0 0 220 19 0 0 0 0 70 0 0 0 0 0 0 0 0 0 0 
13 13 13 125 0 0 19 20 206 0 0 0 0 0 0 0 0 0 0 0 0 0 0 0 0 
13 13 13 13 194 28 11 11 11 0 0 0 0 0 0 0 0 0 0 0 0 10 0 0 0 
19 20 28 28 28 28 28 28 28 28 28 28 0 0 0 0 0 0 264 264 264 264 9 264 264 
27 27 27 27 27 27 27 27 27 27 27 27 27 27 120 27 27 27 27 27 27 27 27 8 27 
